WE texture/north_texture.xpm
SO texture/south_texture.xpm
NO texture/west_texture.xpm
EA texture/east_texture.xpm

C 255,0,0
F 1,100,0



1111111
1000001
1010101
100S001
1000001
1010101
1000001
1111111
