WE texture/north_texture.xpm
SO texture/south_texture.xpm
NO texture/west_texture.xpm
EA texture/east_texture.xpm

C 255,0,0
F 1,100,0

1111111111
11111N1011
1000000001
1000000001
1000000001
1111111111